WWWWWWWWWWWWWWWWWWWWW
WVVV-------------VVVW
WVVVE-----------EVVVW
W-------------------W
W-------------------W
W-------------------W
W-------------------W
W-------------------W
WVVVE-----------EVVVW
WVVV-------------VVVW
WWWWWWWWWWWWWWWWWWWWW