WWWWWWWWWWWWWWWWWWWWW
W--V----------------W
W---------------V---W
W-------------------W
W-------------------W
W---------V---------W
W-------------------W
W--V---------------VW
W-------------------W
W-----V--------V----W
WWWWWWWWWWWWWWWWWWWWW