WWWWWWWWWWWWWWWWWWWWW
W-S---------------S-W
W-------------------W
W--------HHH--------W
W-------HHHHH-------W
W------HHHHHHH------W
W-------HHHHH-------W
W--------HHH--------W
W-------------------W
WVV---------------VVW
WWWWWWWWWWWWWWWWWWWWW