WWWWWWWWWWWWWWWWWWWWW
W-S--S---------S--S-W
W-------------------W
W-------------------W
W----------E--------W
W-------------------W
W-------------------W
W---E-----------E---W
WHHHHHHHH---HHHHHHHHW
WHHHHHHHH---HHHHHHHHW
WWWWWWWWWWWWWWWWWWWWW