WWWWWWWWWWWWWWWWWWWWW
W-VV-------------VV-W
W-------------------W
W---E-----------E---W
W-------------------W
W-------------------W
W-------------------W
W---E-----------E---W
W-------------------W
W-VV-------------VV-W
WWWWWWWWWWWWWWWWWWWWW