WWWWWWWWWWWWWWWWWWWWW
W-------------------W
W-------------------W
W--V-------------V--W
W---------P---------W
W-------------------W
W-------------------W
W---------V---------W
W-------------------W
W-------------VV----W
WWWWWWWWWWWWWWWWWWWWW