WWWWWWWWWWWWWWWWWWWWW
WHHHHHHHH---HHHHHHHHW
WH--E------------E-HW
WH-----------------HW
W-------------------W
W-------------------W
W-------------------W
WH-----------------HW
WH-E-------------E-HW
WHHHHHHHH---HHHHHHHHW
WWWWWWWWWWWWWWWWWWWWW