WWWWWWWWWWWWWWWWWWWWW
W-------------------W
W---E-----------E---W
W-------------------W
W---------S---------W
W--------SSS--------W
W---------S---------W
W-------------------W
W---E-----------E---W
W-------------------W
WWWWWWWWWWWWWWWWWWWWW