WWWWWWWWWWWWWWWWWWWWW
W--V----------------W
W---------------V---W
W----E--------------W
W-------------------W
W---------V---------W
W-----------E-------W
W--V---------------VW
W--E----------------W
W-----V--------V--E-W
WWWWWWWWWWWWWWWWWWWWW