WWWWWWWWWWWWWWWWWWWWW
WHHHHHHHH---HHHHHHHHW
WHHHHHHHH---HHHHHHHHW
W-------------------W
W---------E---------W
W-------------------W
W---------E---------W
W-------------------W
WHHHHHHHH---HHHHHHHHW
WHHHHHHHH---HHHHHHHHW
WWWWWWWWWWWWWWWWWWWWW