WWWWWWWWWWWWWWWWWWWWW
W-S--E------------S-W
W-------------------W
W--------HHH--------W
W-------HHHHH-------W
W------HHHHHHH------W
W-------HHHHHE------W
W--------HHH--------W
W--E----------------W
WVV------------E--VVW
WWWWWWWWWWWWWWWWWWWWW