WWWWWWWWWWWWWWWWWWWWW
WE-----------------EW
W-------------------W
WS-----------------SW
W-------------------W
W---------S---------W
W-------------------W
W-------------------W
W--E-------------E--W
W-------------------W
WWWWWWWWWWWWWWWWWWWWW