WWWWWWWWWWWWWWWWWWWWW
WVVV-------------VVVW
WVVV-------------VVVW
W-------------------W
W-------------------W
W-------------------W
W-------------------W
W-------------------W
WVVV-------------VVVW
WVVV-------------VVVW
WWWWWWWWWWWWWWWWWWWWW