WWWWWWWWWWWWWWWWWWWWW
W-S--S---------S--S-W
W-------------------W
W-------------------W
W-------------------W
W-------------------W
W-------------------W
W-------------------W
WHHHHHHHHHHHHHHHHHHHW
WHHHHHHHHHHHHHHHHHHHW
WWWWWWWWWWWWWWWWWWWWW